Сочетания клавиш и горячие клавиши в Word

Применяется к: Word 2016 Word 2013 Word 2010 Word 2007 Word Starter 2010
В этой статье описаны все сочетания клавиш для приложения Microsoft Word в раскладке клавиатуры для английского (США) языка. Клавиши других раскладок могут не соответствовать ей.
Список сочетаний клавиш можно скачать в виде документа Word по следующей ссылке: Сочетания клавиш в Word 2016 для Windows.
ПРИМЕЧАНИЕ : В сочетаниях, где одновременно нажимается несколько клавиш, обозначения клавиш разделяются знаком плюса (+). Если же клавиши нажимаются последовательно, они разделяются запятой (,).

1) Часто используемые сочетания клавиш
2) Перемещение по ленте с помощью клавиатуры
3) Справочник по сочетаниям клавиш в Microsoft Word
4) Справочник по функциональным клавишам
5) Часто используемые сочетания клавиш

1) В этой таблице перечислены самые распространенные сочетания клавиш для Microsoft Word.
Действие - Сочетание клавиш1;

Перейти в поле "Что вы хотите сделать?" - ALT+Q
Открыть - CTRL+O
Сохранить - CTRL+S
Закрыть - CTRL+W
Вырезать - CTRL+X
Копировать - CTRL+C
Вставка - CTRL+V
Выбрать все - CTRL+A
Полужирный - CTRL+B
Курсив - CTRL+I
Подчеркнутый - CTRL+U
Уменьшить размера шрифта на один пункт - CTRL+[
Увеличить размера шрифта на один пункт - CTRL+]
Выровнять текст по центру - CTRL+E
Выровнять текст по левому краю - CTRL+L
Выровнять текст по правому краю - CTRL+R
Отмена - ESC
Отменить операцию - CTRL+Z
Повторить операцию - CTRL+Y
